█████████████████████████████████
███    X  █   $  ██  X      █████
██  █████   $   ███    ██ ██ X ██
█  ██  $███████  █   ███       ██
█X$█ $    X  █     █  T█████  ███
█ █████ █ ██ ███████████ $ ██ ███
█ █   █ █ ██  B█ X              █
█ █T█ █ █  ██  █ █████ ██   X  ██
█X  █   ██   █████ █   ██     ███
████████████ ███ $███ ████  H  ██
█$           █  $      █        █
███D████████████████████████S████