█████████████████████████████
█           █               █
█  $        █               D
█            ████████       █
█       █                   █
█       █           B       █
█   H   █                   █
█████████████████████████████